25,15,1,64,64,

1,1,1,1,1,1,1,1,1,1,1,1,1,1,1,1,1,1,1,1,1,1,1,1,1,
1,1,1,1,1,1,1,1,1,1,1,1,1,1,1,1,1,1,1,1,1,1,1,1,1,
1,1,1,1,2,2,2,2,2,2,2,2,2,2,2,2,2,2,2,3,1,1,1,1,1,
1,1,1,1,2,2,6,7,7,7,7,7,7,7,7,7,7,7,9,3,1,1,1,1,1,
1,1,1,1,2,2,9,2,2,2,2,2,2,2,2,2,2,2,9,3,1,1,1,1,1,
1,1,1,1,2,2,4,2,2,1,1,1,1,1,1,1,2,2,9,3,1,1,1,1,1,
1,1,1,1,2,2,9,2,3,1,1,1,1,1,1,1,1,2,9,3,1,1,1,1,1,
1,1,1,1,2,2,4,2,3,1,1,1,1,1,1,1,1,2,9,3,1,1,1,1,1,
1,1,1,1,2,2,9,2,2,1,1,1,1,1,1,1,2,2,9,3,1,1,1,1,1,
1,1,1,1,2,2,4,2,2,2,2,2,2,2,2,2,2,2,2,3,1,1,1,1,1,
1,1,1,1,2,2,9,2,7,7,7,7,7,7,7,7,2,2,2,3,1,1,1,1,1,
1,1,1,1,1,2,9,2,1,1,1,1,1,1,1,1,1,1,1,1,1,1,1,1,1,
1,1,1,1,1,1,1,1,1,1,1,1,1,1,1,1,1,1,1,1,1,1,1,1,1,
1,1,1,1,1,1,1,1,1,1,1,1,1,1,1,1,1,1,1,1,1,1,1,1,1,
1,1,1,1,1,1,1,1,1,1,1,1,1,1,1,1,1,1,1,1,1,1,1,1,1

